1111111111
1000000001
100C000001
1000000001
10P0000001

10000C0001
1000000001
1000E00001
1111111111
