1111111111
1000000001
100C000001
1000P00001
1000000001
10P00C0001
1000000001
1000E00001
1111111111
