1111111111
1000000001
100C000001
1000000001
10E0000001
1000000001
1000P00001
10000D0001
1000000001
1111111111
