1111111111111111111
1000000000000000001
1000000000000000001
1000C00000000000001
100E000000000000001
100000P000000000001
1000000000000000001
1000000000000000001
1000000000000000001
1111111101111111111
