111111111111111111111111111111111111111111111111111111111111111111111111111111111111111111111111111
1000000000000000000000000000000000000000C00000000000000000000000000000000000000000000000000000000E1
1000000C00000000000000000C00000000000000000111111111111000000C00000000C0000010111100011111111110001
10P000000000000000000000000000000000000000000000C0000000000000000000000000000000C100000000000000001
10000000000000000C00000000000000000000000000000000000000000000000C000000000000000100000000000000001
111111111111111111111111111111111111111111111111111111111111111111111111111111111111111111111111111
