1111111111111111111
1000000000000000001
1000000000000000001
000C000000000000001
1000000E00000000001
1000000000000000001
100000P000000000001
1000000000000000001
1000000000000000001
1111111111111111111
