1111111111111111111
1000000000000000001
1000000000000000001
1000000000000000000
100C000000000000001
1000000E00000000001
100000000000P000001
1000000000000000001
1000000000000000001
1111111111111111111
