1111111111111111
1000000001
1000000000001
1000000000000001
1111100000001111
11111111111111
