111111111
100000001
10P00C001
100000001
100000001
100C00001
100000001
10C00E001
100000001
111111111
