11111111111111111111111111111
100000000000C00100000000000C1
10111111111111110011111111111
10000C0000000000000C000000001
111C0111111111111111111110001
10000000000000000000000C10001
11111111111100000001111111101
100C0000000000000001C00000001
1000010000000P000001111111111
1111110C000000000000000000001
10000110000000000000001000001
10000C1000000000000C001000001
100001100000C0000000001000001
10000000000000011111111000001
1000000000000001E0C0000000001
11111111111111111111111111111
